{
	"Id": 3,
	"Width": 7,
	"Height": 12,
	"L": [
		" #####",
		"##   ##",
		"#    @#",
		"#$#####",
		"#  ...#",
		"# $ $ #",
		"#...$ #",
		"#### ##",
		"#     #",
		"# $$  #",
		"##   ##",
		" #####"
	]
}
