{
	"Id": 4,
	"Width": 9,
	"Height": 14,
	"L": [
		" ########",
		" #      #",
		" # # #  #",
		"## # #$ #",
		"#  $  $ #",
		"#  $  # #",
		"## #$ # #",
		" # #  $ #",
		" # ##$# #",
		" #  #   #",
		"##  #####",
		"#    ####",
		"#......+#",
		"#########"
	]
}
